0 0 0 0 0 0 0 0 0 0 0 0
0 0 0 3 0 0 0 0 0 0 0 0
0 3 3 3 2 2 2 2 2 2 2 0
0 3 3 3 2 2 2 2 2 2 2 0
0 3 3 3 2 2 2 2 2 2 2 0
0 0 0 3 0 0 0 0 0 0 0 0
0 0 0 0 0 0 0 0 0 0 0 0
1 2 3 1 2 3 1 2 3 1 2 3
2 3 1 2 3 1 2 3 1 2 3 1